						******************************
						*            MAP             *
						*  %%BGFSDB*^^@%%%^**SBC$$T%^*
						*   $%#%G@^G%G$#^&(**NJ**    *
						*                            *
						*           %B^H^G$G#GF$     *
						*  ^%#G%$^GG^$@HJJ*((((M TS$ *
						*                            *
						******************************